1111111111111
1P000000000E1
100000C000011